#######################
#.....................#
#..@..................#
#.##....##########....#
#.......##########....#
#...###...............#
#.....................#
#.....................#
#.....................#
#.....................#
#.....................#
#.....................#
#.....................#
#.....................#
#.....................#
#.....................#
#.....................#
#######################
