################
#..............#
#..............#
#...###........#
#...#######....#
#...#.....#....#
#...#.....#....#
#...#..@..#....#
#...#.....#....#
#.........#....#
#.....#####....#
#..............#
#..............#
#..............#
#..............#
################